1111111111
1P00000001
1011111101
1C000001C1
1110111101
1C000000C1
1011111101
1C000000C1
100E000001
1111111111
