1111111111
1P000000E1
1011111101
1C000001C1
1110111101
1C000000C1
1011111101
1C000000C1
1000000001
1111111111
